1111111111
1ECP000001
1C0000000001
1111111111