1111111111111
11111000000P1
10111000C0001
111100C000E01
1111111111111