1111111111
1ECP000001
1C00000001
1111111111