11111111111111111111
10000000000000000001
10011111111111111101
1001PC00000000001001
10010011111111001001
10010010000001001001
10010010011101001001
10010010010001001001
1001E010010001001001
10010010010001001001
11111111111111111111