1111111111111
100000P000001
1000000E00001
1000C00000001
1111111111111