11111111
1E10PC01
1C101001
100011C1
11111111