111111111
10E0000P1
10010C101
10C00C001
111111111