111111111
1E0000CP1
1001111C1
10C0000C1
111111111