1111111111
11CP0E0001
1011C0C001
1111111111